ajmccart = Alice McCarthy <ajmccart@usgs.gov>
ayan = Andrew Yan <ayan@usgs.gov>
bdgarner = Bradley Garner <bdgarner@usgs.gov>
cschroed = Carl Schroedl <cschroedl@usgs.gov>
cwardgar = Christian Ward-Garrison <cwardgar@usgs.gov>
dblodgett = David Blodgett <dblodgett@usgs.gov>
dekester = Daniel Kester <dekester@usgs.gov>
dmsibley = David Sibley <dmsibley@usgs.gov>
drsteini = Dave Steinich <drsteini@usgs.gov>
dschmitt = David Schmitt <dschmitt@usgs.gov>
duselman = David Uselmann <duselmann@usgs.gov>
eeverman = Eric Everman <eeverman@usgs.gov>
eric = Eric Everman <eeverman@usgs.gov>
gijohnso = Gabriel Johnson <gijohnso@usgs.gov>
hudson = CIDA Jenkins <cida_javadev@usgs.gov>
ilinkuo = I-Lin Kuo <ilinkuo@usgs.gov>
isuftin = Ivan Suftin <isuftin@usgs.gov>
jcotter = John Cotter <jcotter@usgs.gov>
jfwalker = John Walker <jfwalker@usgs.gov>
jiwalker = Jordan Walker<jiwalker@usgs.gov>
jlthomps = Jessica Thompson <jlthomps@usgs.gov>
jlucido = Jessica Lucido <jlucido@usgs.gov>
john = John Hollister <jrhollis@usgs.gov>
jread = Jordan Read <jread@usgs.gov>
jrhollis = John Hollister <jrhollis@usgs.gov>
klangsto = Keith Langston <klangsto@usgs.gov>
kmschoep = Kathy Schoephoester <kmschoep@usgs.gov>
ldecicco = Laura De Cicco <ldecicco@usgs.gov>
lkranendonk = Laura De Cicco <ldecicco@usgs.gov>
lmurphy = Lorraine Murphy <lmurphy@usgs.gov>
mbucknel = Mary Bucknell <mbucknell@usgs.gov>
mccullou = Carolyn Emmanuelli <mccullou@usgs.gov>
mmyers = Matt Myers <mmyers@usgs.gov>
morgan = Morgan Schneider <moschnei@usgs.gov>
mtruiz = Matt Ruiz <mtruiz@usgs.gov>
mwarren = Meredith Warren <mwarren@usgs.gov>
mwstern = Michael Stern <mwstern@usgs.gov>
nate = Nate Booth <nlbooth@usgs.gov>
nlbooth = Nate Booth <nlbooth@usgs.gov>
phethala = Phethala Thongsavanh <thongsav@usgs.gov>
poschell = Peter Schell <poschell@usgs.gov>
razoerb = Ryan Zoerb <razoerb@usgs.gov>
rhayes = Rodger Hayes <rhayes@usgs.gov>
rjhollis = John Hollister <jrhollis@usgs.gov>
sfphilli = Susan Phillips <sfphilli@usgs.gov>
spkemna = Steven Kemna <spkemna@usgs.gov>
tcadkin = Tracey Reinke <tcadkin@usgs.gov>
thongsav = Phethala Thongsavnh <thongsav@usgs.gov>
tkunicki = Tom Kunicki <tkunicki@usgs.gov>
wblondea = Bill Blondeau <wblondea@usgs.gov>
xyang = Xao Yang <xyang@usgs.gov>
linaye = linaye <linaye@usgs.gov>
